당나귀|노새|버새|돼지|면양|산양|닭고기|칠면조
오리|거위|포유동물|고래|물개|낙타|사슴|여우|밍크
파충류|자라|거북|조류|앵무새|타조|꿀벌|갯지렁이|실지렁이
소고기|냉동 소고기|돼지고기|양고기|말고기|식용설육|토끼|해양동물|비계|훈제고기
염장고기|활어|비단잉어|송어|뱀장어|참다랑어|방어|치어|장어
넙치|농성어|복어|농어|볼락|숭어|미꾸라지|메기|붕어|연어
잉어|다랑어|청어|멸치|정어리|고등어|삼치|꽁치|명태|상어
홍어|갈치|상어지느러미|냉동어류|생선|건조어류|훈제어류|염장어류|갑각류|가재
대게|새우|연체동물|굴|가리비|홍합|오징어|문어|달팽이|낙지
쭈꾸미|조개|전복|골뱅이|해삼|멍게|성게|해파리|밀크|크림
분유|연유|버터밀크|요구르트|케피어|응고밀크|응고크림|유장|버터|치즈
새알|천연꿀|거북알|로열젤리|인모|머리카락|브러시털|돼지털|오소리털|염소털
동물장|동물방광|동물위|새깃털|새솜털|깃털가루|뼈|뼛가루|아이보리|상아
녹용|녹각|귀갑|고래수염|사슴뿔|산호|패각|용연향|사향|췌장
담즙|동물정액|동물피|수정란|동물사체|누에번데기|알뿌리|치커리|튤립|백합
아이리스|프리지아|수선화|과일나무|사과나무|배나무|호두나무|잣나무|철쭉|진달래
장미|난초|안개초|국화|선인장|소나무|편백|단풍나무|버섯 종균|카네이션
이끼|식물잎|은행잎|감자|토마토|양파|쪽파|마늘|배추
양배추|케일|상추|당근|순무|무|고추냉이|겨자무|더덕|도라지
오이|완두|대두|채두류|아스파라거스|버섯|송로|고추|시금치|올리브
호박|고사리|냉동채소|스위트콘|녹두|강낭콩|돼지감자|고구마|토란
코코넛|브라질넛|캐슈넛|아몬드|헤이즐넛|호두|피스타치오|마카다미아
은행|바나나|대추야자|무화과|파인애플|아보카도|구아바|망고|망고스틴|감귤
오렌지|레몬|라임|자몽|포도|건포도|멜론|수박|파파야|사과
국산배|살구|체리|복숭아|자두|딸기|오디|크렌베리|키위|두리안
꽃감|대추|매실|냉동 딸기|냉동 밤|냉동 대추|냉동 잣|감귤류껍질|수박껍질|멜론껍질
커피|녹차|홍차|마테(mate)|후추|바닐라|계피|정향|육두구|소두구
코리앤더씨|커민씨|아니스씨|대회향씨|캐러웨이씨|회향씨|주니퍼열매|생강|샤프란|카레
강황|월계수|밀가루|메슬린|호밀|보리|귀리|옥수수|팝콘|쌀
현미|정미|멥쌀|찹쌀|쇄미|수수|메밀|조|카나리시드
포니오|퀴노아|라이밀|밀가루|메슬린가루|옥수수가루|보릿가루|쌀가루|호밀가루|율무
씨눈|감자가루|콩가루|칡뿌리|맥아|전분|이눌린|글루텐|대두|땅콩
코프라|아마씨|유채씨|해바라기씨|팜너트|목화씨|피마자|참깨|겨자씨|잇꽃종자
멜론종자|양귀비씨|들깨|시어너트|채유용종자|과실가루|파종용종자|홉|루플린|인삼
수삼|산양삼|백삼|홍삼|코카잎|양귀비줄기|구기자|오미자|백수오|하수오
로커스트콩|해초류|김|미역|톳|파래|다시마|우뭇가사리|돌가사리|사탕무
사탕수수|치커리뿌리|곡물짚|곡물껍질|사료용식물|락|천염검|수지|레진|식물성수액
마약류|감초|편조물용 식물성재료|식물성생산품|돼지지방|소지방|양지방|라드유|어유|경유
울그리스|동물성유지|대두유|땅콩기름|올리브유|버진|팜유|해바라기씨유|목화씨유|면실유
야자유|유채유|겨자유|식물성유지|아마씨유|옥수수유|참기름|피마자유|들기름|동백유
고래기름|마가린|변성유지 및 비식용유지|글리세롤|식물성왁스|팜왁스|데그라스|소시지|삼계탕|넓적다리살
육즙|육추출물|어류 추출물|어류즙|어류조제품|캐비아|바닷가재|새조개|사탕수수당|메이플시럽
포도당시럽|과당시럽|캐러멜당|맥아당|당밀|설탕과자|캐러멜|캔디|코코아두|코코아 껍질
코코아 페이스트|코코아 버터|코코아 가루|초콜릿|초콜릿과자|코코아조제품|조제분유|맥아추출물|오트밀|파스타
스파게티|마카로니|국수|당면|냉면|라면|쿠스쿠스|타피오카|콘플레이크|비스킷
와플|건빵|케이크|쿠키|크래커|쌀과자|라이스페이퍼|피클|오이피클
양파절임|락교|토마토 페이스트|양송이버섯|표고버섯|송이버섯|감자크로켓|죽순|김치|곤드레
파인애플 통조림|잼|과일젤리|피넛버터|오렌지쥬스|파이애플쥬스|토마토쥬스|사과쥬스|포도쥬스|딸기쥬스
인스턴트커피|효모|제빵효모|스피루리나|베이킹파우더|간장|토마토케첩|토마토소스|겨자|된장
춘장|마요네즈|메주|수프|브로드|아이스크림|빙과류|두부|인삼차|홍삼차
커피크리머|광천수|탄산수|음료|인삼음료|과실음료|식혜|맥주|포도주
레드와인|화이트와인|베르무트|과실발효주|청주|약주|탁주|사케|주정|꼬냑
위스키|보드카|인삼주|오가피주|소주|고량주|데낄라|식초|사료|쌀겨
동물사료|개사료|고양이사료|잎담배|시가|궐련|필터담배|씹는담배|파이프담배|담배
소금|천일염|황화철광|황|천연 흑연|천연 모래|석영|고령토|점토|초크
천연인산칼슘|중정석|독중석|규조토|부석|금강사|슬레이트|대리석|화강암|자갈
현무암|백운석|마그네사이트|석고|석회석|생석회|시멘트|석면|운모|천연동석
천연붕산염|장석|백류석|황화비소|연망간광|규회석|철광|망간광|동광|니켈광
코발트광|알루미늄광|연광|아연광|주석광|크롬광|텅스텐광|우라늄광|몰리브덴광|티타늄광
지르코늄광|귀금속광|기타의 광|슬랙샌드|기타 웨이스트|잔재물|폐기물|석탄|연탄|조개탄
갈탄|토탄|코크스|석탄가스|콜타르|벤젠|톨루엔|크실렌|나프탈렌|페놀
피치|석유|휘발유|항공유|등유|제트연료유|중유|석유가스|천연가스|프로판
부탄|석유왁스|파라핀왁스|석유코크스|아스팔트|광물성타르|전기에너지|이식용 피부|이식용 뼈|웅담
헤파린|혈액|헤모글로빈|혈청|백신|바이러스|구충제|항암제|비타민제|녹용제제
인삼제제|로열젤리 제제|탈지면|거즈|붕대|반창고|의료용품|진단용 시약|봉합제|동물성비료
식물성비료|질소비료|인산비료|칼륨비료|광물성비료|화학비료|유연제|착색제|레이크안료|안료
법랑|유약|페인트|바니시|에나멜|드라잉오일|오일바니시|디스템퍼|조제드라이어|유성물감
수성물감|퍼티|매스틱|도장용충전제|인쇄용잉크|필기용잉크|제도용잉크|복사용잉크|볼펜용잉크|유성잉크
수성잉크|금속성잉크|마크용잉크|오렌지유|레몬유|바닐라유|방향성물질|향수|화장품|선크림
매니큐어|페디큐어|립스틱|아이섀도|베이비파우더|샴푸|헤어제품|린스|트리트먼트|치약
치실|가글|구강세척제|면도제품|데오드란트|목욕소금|탈모제|향낭|방향제|렌즈세척액
마스크팩|비누|계면활성제|조제세제|조제윤활유|왁스|광택제|양초|치과용 왁스|카세인
알부민|젤라틴|펩톤|케라틴|덱스트린|글루|조제글루|조제접착제|효소|화약
폭약|도화선|도폭선|뇌관|점화기|전기뇌관|불꽃제품|신호용 조명탄|레인로켓|안개신호용품
성냥|페로세륨|고체 연료|액체 연료|가죽|가죽케이스|가죽가방|가죽의류|가죽장갑|가죽벨트
가죽띠|생모피|모피|모피제품|모피의류|인조모피|땔나무|목탄|원목|말뚝
목모|목분|목재|제재목|합판용 단판|파티클보드|섬유판|합판|그림틀|사진틀
나무케이스|팰릿|나무통|목재 공구|건축용 목재|도마|젓가락|대접|공기|나무장식품
옷걸이|이쑤시개|대나무|등나무|인쇄물|백과사전|리플릿|신문|잡지|그림책
악보|지도|해도|설계도|우표|수입인지|전사지|그림엽서|캘린더|카달로그
충전재|펠트|부직포|고무실|고무끈|금속드리사|짐프사|밧줄|로프
케이블|어망|그물|남성용 외투|여성용 외투|남성용 수트|바지|여성용 수트|남성용 셔츠
여성용 블라우스|남성용 내의류|여성용 내의류|티셔츠|저지|풀오버|카디건|유아용 의류|트랙슈트|스키복
수영복|레인코트|방수복|잠수복|앞치마|가운|특수복|양말|장갑|스카프
머플러|넥타이|손수건|머리밴드|여성용 의류|브래지어|거들|코르셋|숄|의류부속품
모포|린넨|커튼|침구|포장용 포대|방수포|차양|차일|텐트
청소용포|구명재킷|구명벨트|신발끈|보자기|드레스패턴|자수용 세트|구제의류|넝마|우산
양산|지팡이|깃털|조화|인조 꽃|인조과실|인조잎|사람머리카락|가발|인조속눈썹
인조수염|포석 연석|판석|비석|건축용 석재|밀스톤|그라인딩휠|연마포 연마지|스래그 울|암면
패널|보드|타일|블록|플라스터|plaster|석면시멘트|마찰재료|흑연|탄소섬유
이탄제품|진주|다이아몬드|루비|사파이어|에메랄드|오팔|비취|옥수|수정
인조수정|석류석|은|금|백금|금액세서리|은액세서리|백금액세서리|금세공품|은세공품
촉매제|천연진주|양식진주|커프링크|목걸이|팔찌|귀걸이|브로치|반지|주화
금화|은화|텅스텐|몰리브데늄|탄탈륨|마그네슘|코발트|비스무트|카드뮴|티타늄
지르코늄|안티모니|망간|베릴륨|크로뮴|탈륨|게르마늄|바나듐|갈륨|하프늄
인듐|니오븀|레늄|서멧|농업공구|원예공구|가래|삽|곡괭이|픽스
도끼|전정가위|전지가위|낫|포크|플라이어|스패너|렌치
망치|스크루드라이버|가정용공구|공구세트|호환성공구|기계용칼|기구용칼|공구용판 공구용봉 공구용팁|분쇄기|추출기
압착기|믹서|세절기|커터|오프너|실러|칼|면도기|면도날|가위
종이용칼|연필깎이|손톱용품|이발기|주방용칼|스푼|국자|생선용칼|버터용칼|주방용집게
자물쇠|열쇠|장착구|부착구|금고|사무비품|사무용품|벨|징|틀
거울|플렉시블 튜빙|아이|아일릿|버클|코르크|캔뚜껑|사인판|명판
표지판|용접봉|원자로|증기발생보일러|과열수보일러|중앙난방용보일러|보일러용 부속기기|발생로가스|수성가스발생기|아세틸렌가스발생기
습식가스발생기|증기터빈|선박추진용터빈|불꽃점화식피스톤내연기관|압축점화식피스톤내연기관|내연기관부분품|수력터빈|수차|터보제트|터보프로펠러
가스터빈|수력엔진|수력모터|압축공기식엔진|압축공기식모터|액체펌프|기체펌프|진공펌프|공기조절기|노용버너
기계식스토커|기계용불판|노|오븐|냉장고|냉동고|냉장기구|냉동기구|물가열기|살균기
건조기|캘린더기|로울기|원심분리기|원심탈수기|액체용여과기|액체용청정기|기체용여과기|기체용청정기|접시세척기
음료용탄산가스주입기|중량측정기기|저울 추|분사용기기|살포용기기|분무용기기|소화기|스프레이건|제트분사기|풀리태클
호이스트|윈치|캡스턴|잭|데릭|크레인|이동식양하대|스트래들캐리어|포크리프트트럭|리프트
에스컬레이터|컨베이어|텔레페릭|불도저|앵글도저|그레이더|레벨러|스크레이퍼|탬핑머신|로드롤러
기계식셔블|멀티버켓굴착기|셔블로더|항타기|항발기|스노플라우|스노블로어|석탄절단기|암석절단기|터널뚫는기계
천공용기계|시굴용기계|시추기|부분품|쟁기|파종기|식부기|이식기|퇴비살포기|비료살포기
수확기|탈곡기|새의알선별기|농산물선별기|착유기|낙농기계|균질기|과실주스추출용프레스|과실주스추출용크러셔|동물사료조제용기계
사료절단기|사료분쇄기|사료배합기|가금사육용기계|부란기|가금류양육기|기계류|트랙터|10인이상자동차|승용차
설상주행용차|골프용차|경주용자동차|화물자동차|덤프차|냉동차|냉장차|탱크차|특수용도차량|기중기차
소방차|콘크리트믹서운반차|살포차|제설차|도로청소차|이동방송차|이동진료차|이동통신차|자동차섀시|차체
완충기|안전벨트|제동장치|기어박스|차축|로드휠|방열기|소음기|배기관|클러치
운전대 에어백|작업차|전차|장갑차량|모터사이클|자전거|신체장애인용차량|모터사이클부분품|자전거부분품|신체장애인용차량부분품
유모차|트레일러|세미트레일러|손수레|우마차|썰매|비행선|글라이더|행글라이더|기구
무동력항공기|헬리콥터|우주선|비행기|항공기|낙하산|로토슈트|항공기발진장치|갑판착륙장치|지상비행훈련장치
순항선|유람선|페리보트|화물선|부선|탱커|냉동선|화객선|어선|어획물가공선
어획물저장선|요트|유람용선박|운동용선박|카누|범선|예인선|푸셔크라프트|특수선박|조명선
소방선|준설선|기중기선|시추대|작업대|해난구조선|부조선|군함|잠수함|구명보트
쇄빙선|병원선|부교|코퍼댐|부잔교|부표|수로부표|해체용선박|광섬유|광섬유다발
광섬유케이블|편광재료판|콘택트렌즈|안경렌즈|프리즘|반사경|대물렌즈|사진기용렌즈|촬영기용렌즈|비디오카메라용렌즈
영사기용렌즈|현미경용렌즈|천체망원경용렌즈|필터|안경테|고글테|선글라스|안경|3D안경|쌍안경
단안경|천체망원경|반사망원경|사진기|수중촬영용사진기|공중측량용사진기|내과용사진기|외과용사진기|즉석인화사진기|폴라로이드
스티커사진기|특수용도사진기|영화용촬영기|영사기|투영기|프로젝터|사진확대기|사진축소기|사진현상실용기기|영화현상실용기기
영사용스크린|광학현미경|입체현미경|편광현미경|금속현미경|위상차현미경|생물현미경|전자현미경|양자현미경|전자회절기기
피아노|현악기|바이올린|첼로|하프|만도린|밴조|기타|관악기|금관악기
트럼펫|트럼본|목관악기|플루트|클라리넷|색소폰|리코더|파이프오르간|아코디언|멜로디카
하모니카|타악기|북|목금|심벌|캐스터네츠|마라카스|탬버린|소고|드럼
팀파니|트라이앵글|실로폰|건반악기|오르간|신디사이저|뮤지컬박스|기계식자명조|뮤지컬소|악기부분품
악기부속품|의자|치과용의자|이발용의자|내과용의자|외과용의자|미용실용의자|수술대|산부인과용검진대|분만대
금속가구|침대|목제가구|책상|식탁|나전칠기|문갑|화장대|장롱|플라스틱가구
보행기|대나무가구|등나무가구|매트리스서포트|매트리스|램프|조명기구|샹들리에|조립식건축물|세발자전거
스쿠터|페달자동차|인형용차|인형용의류|전기식기차|완구용악기|퍼즐|비디오게임|콘솔게임|당구대
당구용구|게임용구|볼링장용구|전자식게임기|축제용품|카니발용품|마술용품|스키|수상스키|서핑보드
골프용품|탁구용구|테니스라켓|배드민턴라켓|축구공|농구공|배구공|핸드볼공|미식축구공|낚싯대
낚싯바늘|낚시용구|회전목마|그네|실내사격연습장용품|놀이공원용품|자개|동물성조각용재료|식물성조각용재료
광물성조각용재료|브러시|바닥청소기|칫솔|수동식체|어레미|여행세트|화장용세트
바느질용키트|신발청소용키트|단추|프레스파스너|스냅파스너|프레스스터드|슬라이드파스너|체인스쿠프|볼펜|만년필
프로펠링펜슬|슬라이딩펜슬|볼펜용심|펜촉|닙포인트|연필|크레용|색연필|연필심|오일파스텔
파스텔|석판|흑판|날짜도장|봉합용스탬프|넘버링스탬프|스탬프|타자기용리본|자동자료처리기계용리본|잉크패드
담배라이터|기계식라이터|전기식라이터|케미컬라이터|비기계식라이터|흡연용파이프|파이프볼|시가홀더|시가렛홀더
머리핀|향수용분무기|화장용분무기|화장용분첩|화장용패드|보온병|보온도시락|마네킹인형|자동인형|위생패드
탐폰|유아용냅킨|냅킨라이너|일각대|양각대|삼각대|회화|데생|판화|인쇄화
석판화|조각|조각상|동물수집품|식물수집품|광물수집품|해부수집품|사학수집품|고고학수집품|고생물학수집품
민족학수집품|고전학수집품|골동품|무기화학품|귀금속|희토류|방사성원소|유기화학품|항생물질|사진필름
사진인화지|사진플레이트|영화용필름|사진용화학조제품|인조흑연|활성탄|살충제|살균제|제초제|소독제
플라스틱|고무|원피|펄프|복사용지|화장지|편지봉투|엽서|견직물|양모
캐시미어|면직물|마직물|우븐패브릭|나일론|폴리에스테르사|인조필라멘트사|합성필라멘트사|나일론사|아크릴사
양탄자|바닥깔개|자수천|메리야스 편물|뜨개질 편물|신발|테니스화|농구화|샌들|부츠
실내화|모자|안전모|벽돌|커피세트|도자기 그릇|유리제품|크리스탈|백미러|강화유리
철강|스테인레스강|합금강|볼트|너트|스크루|안전핀|스프링|구리|니켈
알루미늄|납|아연|주석|전동기|발전기|진공청소기|무선기기|인쇄회로|철도용 기관차
컨테이너|시계|손목시계|무기|리볼버|공기총|가스총|탄약|총포탄|산 동물
육과 식용설육|어패류|낙농품|기타 동물성 생산품|산수목|채소|과실|견과류|향신료
곡물|채유용 종자|식물성 액즙과 엑스|기타 식물성 생산품|동식물성 유지|육류|어류 조제품|당류|코코아와 그 조제품|곡분의 조제품
과실의 조제품|기타의 조제 식료품|주류|조제사료|연초|토석류|광|슬랙|회|광물성 연료
에너지|무기화합물|유기화합물|비료|염료|잉크|향료|변성 전부|화약류|필름
인화지|사진용 재료|각종 화학공업 생산품|원피가죽|가죽제품|조물재료의 제품|지와 판지|서적|견|수모
면|기타 식물성 섬유|인조 필라멘트|인조 스테이플 섬유|워딩|특수직물|침투|도포한 직물|편물|의류(편물제)
의류(편물제 이외)|기타 섬유제품|신발류|모자류|조제우모|인발제품|석면제품|도자제품|유리
귀석|반귀석|철강제품|동|<유보>|연|기타의 비금속|비금속 제공구|각종 비금속 제품|보일러
전기기기|TV|VTR|철도차량|일반차량|선박|광학|측정|검사 정밀기기|악기
가구류|완구|운동용구|잡품|예술품|24시간 통관체제|ACVA|AEO|AEO MRA|AI무역금융사기 모니터링 시스템
AML|APTA|APTA 몽골|ASG(농업긴급수입제한조치)|ATA 까르네|BEPS|CBD|CBD오일|CEPA|CUSTOMS
e-C/O|EODES(전자적원산지정보교환시스템)|EU|FATF|FIU|FTA|FTA 사후적용|FTA 협정|FTA-PASS|FTA검증 정의
FTA경제영토|FTA관세법|FTA수출입활용율|FTA원산지증명서|FTA특혜관세|FTA협상|FTA활용률|FTA활용지도|GSP|HS코드
KCS|KOREA CUSTOMS|k브랜드|MDMA|RCEP|RCEP 최종서명|THC|TPP|TRQ(저율관세할당)|UNIPASS
USMAC|WCO|WTO|X-ray검사|YABA|YES FTA 전문교육|가격신고|가격조작|가산세|가상자산 구매 목적
가상화폐|간이정액환급|감천항|감치|갑질|개별소비세|개별환급|개인용품위장|개인통관고유부호|거래가격
건강기능식품법|건강보험재정편취|건기식|검역|검증 불복|검증 설명회|검증요청 급증|곤약젤리|골든트라이앵글|공공재정편취
공공조달|공익관세사|공조단속|공항세관|과세가격|과세가격 결정방법 사전심사|과세처분|관세|관세 면제|관세감면
관세당국|관세도움정보|관세범|관세법|관세법위반|관세사|관세사범|관세사법위반|관세사시험|관세조사
관세청|관세청장|관세청차장|관세체납|관세탈루|관세평가|관세평가협정|관세포탈|관세행정|관세행정관
관세환급|구매대행|국가재정편취|국고귀속물품|국내제조확인서|국내판매가격|국민건강|국민보건사범|국부유출|국산가장
국산가장수출|국산둔갑|국제간접검증|국제마약조직|국제우편물 통관|국제원산지정보원|국제원산지컨퍼런스|군산항|그린 뉴딜|금괴
금지품수입|금지품수출|금지품수출입|기간초과지급|기납증|기업심사|기업지원|기업지원 설명회|기업지원 이력관리|기초원재로납세증명서
남포항|납부기한연장|납부유예|납세증명서|납세협력프로그램|내국세|내국세탈루|노석환|농산물 가격|농수산물원산지표시에관한법률
누적기준|니코틴|다국적기업|다이궁|다크넷|다크웹|담보|담보기준가격|대리반입|대리운반
대마|대마 합법화|대외무역법|대외무역사범|대한상공회의소|덤빙조사|덤핑방지관세|동종동질|디지털 혁신|디지털증거
디지털포렌식|따이궁|라벨갈이|레플리카 해외직구|리얼돌|마스크|마스크 수출|마약|마약 구속|마약 불구속
마약 수사권|마약 원료물질|마약 탐지견|마약밀수조직|마약수사|마약조사|마약탐지견|메가 FTA|메트암페타민|면세구역
면세쇼핑|면세점|면세점 특허수수료|명단공개|명품 해외직구|모바일 관세청|모바일포렌식|목록배제대상|목록통관|목재제품 품질 합동점검
목재펠릿|무등록외국환업무|무목적 관광비행|무수출죄|무역금융편취|무역기반 경제범죄|무역기반 자금세탁|무역수지|무역위원회|무역통계
무착륙 관광비행|물류허브|물뽕|물품가격|미 CBP|미 대선|미군 마약|미소기준|미중 무역전쟁|민간특송장(자체시설)
밀반입|밀반출|밀수|밀수경로|밀수사건|밀수신고|밀수입|밀수입죄|밀수출|밀수품취득
바이든|반덤핑|반도체 수출 증가|발암물질|방사능|방역|배송대행|법규수행능력|법인심사|보따리
보따리상|보세공장|보세구역|보세구역 특허|보세사 시험|보세운송|보세창고|보세판매장|보정|본부세관
부가가치기준|부가가치세|부산항|부정감면|부정수입|부정수출|부정환급|북한산|북한석탄|북한선박
북한제재|분산반입|분증|분할납부|불공정 무역|불량수입물품 협업|불법물품 반입|불법수입|불법외환거래|비관세장벽
비트코인|비특혜|비특혜원산지|사기 횡령 배임 수사권 부여|사슴태반|사업자통관고유부호|사전세액심사|사후관리|사후심사|상품양허
상호인정약정|서면실태조사|서바이벌 게임용 총 통관|선원밀수|성실신고|세관|세관 체화공매|세관장확인대상|세무조사|세번변경기준
세수|세외수입|세율허위신고|세정제|세정지원|소송|소액 해외직구|소요량|수산물|수입 농수산물
수입가격|수입가격 고가조작|수입가격조작|수입검사|수입검증|수입금지|수입물품 원산지|수입세금계산서|수입세액 정산제도|수입세액분할증명서
수입식품법|수입식품안전관리특별법|수정수입세금계산서|수출가격 저가조작|수출가격조작|수출가장밀수|수출검증|수출원재료에대한관세환급에관한특례법|수출이행기간|수출입
수출입 물동량|수출입가격조작|수출입동향|수출입신고 오류관리|수출입안전관리우수업체|수출입화물 검사비용 지원|수출자 직접조사|수출허위매출|식품 안전관리|식품위생법
신남방국가|신속통관 서비스|신용정보|신종마약|실제지급금액|심지박기|압류|압수수색|액상담배|액상대마
야바|약사법|여행자 휴대품|역외가공기준|역외산 우회수입|역외탈세|역직구|완제품 생산자|외환거래제도|외환검사
요건미구비|용도세율|우범화물|우편물 금지물품|운반책|원산지|원산지 누적기준|원산지 사전확인 컨설팅|원산지검증|원산지결정기준
원산지관리사|원산지규정|원산지무표시|원산지세탁|원산지손상변경|원산지신고서|원산지오인표시|원산지위반|원산지인증수출자|원산지절차
원산지증명서|원산지증명서 발급기관|원산지표시|원산지표시위반|원산지허위표시|원산지확인서|원산지확인서 유효기간|원산지확인위원회|월별납부|위장밀수입
위조상품|위조품|유니패스|유류환적|유사물품|유통실태서면조사|유통이력|은닉|은닉재산|의료기기
의료기기법|이사물품 반입기간|이사물품 자동차|이사자 요건|이온스캐너|이전가격|이찬기|인도네시아 직접운송|인천공항|인천항
인천항 통합검사장|일감몰아주기|일반특혜|일반특혜관세 발급기관|일본|일본산 수산물 수입|일본식품|임시마약류|입국시 세관검사|입국장
자가사용|자금세탁|자유무역|자유무역지역|자유무역지역법|자유무역지역의지정및운영에관한법률|자유무역협정관세법|자유무역협정의이행을위한관세법의특례에관한법률|재산국외도피|저가신고
적하목록|전략물자|전자문서위조변조|전자봉인|전자상거래|전자상거래 플랫폼|정보분석|정부조직 국민참여진단|정부포상|조세회피
종합보세구역|종합심사|중계밀수|중고물품 판매|중국산|지재권 침해물품|직구|직구 150달러|직구 새상품|직구되팔이
직구환급|직접운송|직할세관|진단키트|징수|징수유예|짝퉁|짝퉁물품|체납|체납처분면탈
체납처분유예|체화몰수|체화물품|최소가공기준|출국금지|출국장|충당|치료재료 가격조작|커튼치기|컨테이너 검사
케타민|코로나|코로나19|코카인|타인에대한명의대여|탐지견|터키 수출검증 급증|통관|통관 조회|통관금지 품목
통관단일창구|통관대행업체|통관원활화|통제배달|통합물류창고|통합법규준수도|트럼프|특례관세악용|특별긴급관세|특송
특송,우편물품 통관대책|특송물품 통관정보안내|특송업체|특송통관|특송화물|특수관계|특혜관세적용|특혜원산지|페이퍼컴퍼니|평택세관 해상특송장
평택항|포렌식|포상|포스트 코로나|포워더|품명위장|품목분류|필로폰|하역|한-영 FTA
한-중 연결공정|합동단속|합성대마|해상 특송화물|해상특송장|해외 역직구|해외거래처부호|해외은닉|해외입국자|해외직구
해외직구 건강기능식품|해외직구 관세|광군제|해외직구 리셀|해외직구 반품|블랙프라이데이|해외통관애로|해외통관애로 관세관|해외현지검증|향정신성의약품
허위신고|허위표기|헤로인|현지확인|협정관세|형식적오류|화장품법|환경범죄|환급|환급특례법
환적|환전영업자|환치기|환특법|환특법 환급|후쿠시마|휴대밀수입|휴대품 가산세|휴대품 검사|휴대품 면세
휴대품 모바일 신고|휴대품 세관신고서|휴대품밀수|휴대품유치|태풍|한일수출규제
